8-5
.S.TT..S
.O.TT..C
.......T
..@....C
C......S
